
██╗  ██╗███████╗██╗     ██╗      ██████╗     ██╗    ██╗ ██████╗ ██████╗ ██╗     ██████╗ 
██║  ██║██╔════╝██║     ██║     ██╔═══██╗    ██║    ██║██╔═══██╗██╔══██╗██║     ██╔══██╗
███████║█████╗  ██║     ██║     ██║   ██║    ██║ █╗ ██║██║   ██║██████╔╝██║     ██║  ██║
██╔══██║██╔══╝  ██║     ██║     ██║   ██║    ██║███╗██║██║   ██║██╔══██╗██║     ██║  ██║
██║  ██║███████╗███████╗███████╗╚██████╔╝    ╚███╔███╔╝╚██████╔╝██║  ██║███████╗██████╔╝
╚═╝  ╚═╝╚══════╝╚══════╝╚══════╝ ╚═════╝      ╚══╝╚══╝  ╚═════╝ ╚═╝  ╚═╝╚══════╝╚═════╝ 
                                                                                        
